title	tags
Como desenhar um gráfico de pontos empilhados no R?	["r"] 
selecionar todos os registros do MySQL onde um campo de data e hora é menor que um valor especificado	["php", "mysql"]
Como encerrar um aplicativo do Windows Phone 8.1	["c#"]
obter a hora atual em um país específico via jQuery	["javascript", "jquery"]
Configurando o Tomcat para usar SSL	["java"]
Plugin Awesome Nested Set - como adicionar novos filhos à árvore em vários níveis	["ruby-on-rails"]
Como criar um mapa a partir de uma resposta JSON no Ruby on Rails 3?	["ruby", "ruby-on-rails-3", "json"]
testar rspec se o método é chamado	["ruby"]
Exceção SpringBoot Catalina LifeCycle	["java", "spring", "spring-mvc"]
Como importar dados do Excel para um banco de dados MySQL usando PHP	["php", "codeigniter"]
Obtendo o objeto java.lang.Class<T> para um tipo parametrizado sem construir a classe em q_uestion?	["java", "class"]
iPad não seleciona todo o texto dentro de uma entrada de texto ao tocar	["javascript", "jquery", "html", "ios"]
Como o $ do jQuery é uma função e um objeto?	["javascript", "jquery"]
Eclipse C++ MinGW - Não é possível iniciar o programa <Terminado>	["c++", "eclipse"]
Em JavaScript, como posso chamar um método de protótipo em outro método de protótipo?	["javascript"]
obter interseção de uma lista de conjuntos	["python", "list"]
Não é mais possível ocultar o teclado durante o viewWillDisappear no iOS7	["ios", "objective-c"]
Como buscar a chave de um JSON em Swift?	["ios", "json", "swift"]
Como alterar o modelo de cabeçalho do Pivot no Windows Phone 8	["c#", "xaml"]
criptografia da connectionString	["c#", "asp.net"]
Como permitir que a interface do usuário seja atualizada durante uma operação UI demorada	["c#", "wpf", "multithreading"]
Melhor maneira de executar um arquivo Ruby usando Python e como obter a saída do console Ruby quando o arquivo Ruby é executado a partir do Python?	["python", "ruby"]
criar 2 miniaturas de uma vez no CodeIgniter	["php", "imagem", "codeigniter"]
Caractere Java vs char: o que dizer sobre o uso de memória?	["java", "performance"]
Fechar modal do Bootstrap ao pressionar a tecla Enter	["javascript", "jquery", "twitter-bootstrap"]
Consulta Linq com agrupamento para recuperar a porcentagem	["c#", "linq"]
Problema com campo de rótulo - OpenErp	["python", "xml"]
Como manter 2 objetos sempre visíveis, escalando o campo de visão? (ou eixo z e y)	["c#"]
Atributo AttributeError: objeto "NoneType" não possui o atributo "split"	["python"]
Como anexar a um arquivo .mat usando scipy.io.savemat?	["python", "numpy"]
Substituir o onClick do JQuery em h:commandLink	["javascript", "jquery"]
Como redirecionar a saída de um programa Ruby para algum arquivo	["ruby"]
Erro "Access-Control-Allow-Origin" ausente no recurso solicitado	["javascript", "jquery", "ajax", "json"]
Criando JSON no Windows 8 C# usando IJsonValue: Não é possível converter implicitamente o tipo "string" para "Windows.Data.Json.IJsonValue"	["c#", "json"]
Capitalização de rótulo do Django ModelForm	["django"]
como mostrar/ocultar div com slide em JavaScript (sem jQuery)	["javascript"]
Como evitar o giro ocupado em Java	["java", "multithreading"]
Laravel 4: Input::all() não retorna dados com $.ajax POST	["php", "jquery", "ajax", "laravel"]
Como lidar com net::ERR_CONNECTION_REFUSED no jquery ajax	["javascript", "jquery", "ajax"]
Função Year no R	["r"]
Como usar o retrofit como um singleton enquanto usa o conversor gson?	["java", "android", "rest"]
Como usar o SetTimer em um arquivo .cpp não relacionado a diálogo em meu aplicativo MFC?	["c++"]
Copiando uma referência web para um novo projeto	["c#", "asp.net", "asp.net-mvc", "web-services"]
Consulta LINQ para selecionar os cinco primeiros	["c#", "linq"]
JavaScript: como posso inserir uma string em um índice específico	["javascript", "string"]
Apache POI: alterar o formato da página para planilha do Excel	["java", "excel"]
Barra de progresso indeterminada do Python Tkinter não está em execução	["python"]
como armazenar o caminho da imagem no banco de dados MySQL usando C#	["c#", "mysql", "winforms"]
Erro de conexão jdbc: não associado a uma conexão gerenciada	["java"]
Como usar várias tabelas em um modelo no yii2	["php", "mysql"]
Obter todos os nomes de controladores no ASP.NET MVC4	["c#", "asp.net", "asp.net-mvc"]
conversão de matriz de inteiros para matriz de objetos em Java	["java", "arrays"]
Erro ao fazer upload de arquivo em PHP	["php"]
Métodos clear() em Java	["java"]
Impressão de floats com um número específico de zeros	["python"]